8 8 2 1 6 6
0 0 0 0 0 0 0 0
0 1 1 0 0 1 1 1
0 1 50 1 1 1 0 1
1 20 1 1 0 90 10 1
1 0 0 1 0 0 1 20
1 0 0 10 0 0 1 0
1 1 1 1 1 0 1 0
0 0 0 0 1 1 1 0